NO ./Texture/colorstone.xpm
SO ./Texture/greystone.xpm
WE ./Texture/colorstone.xpm
EA ./Texture/redbrick.xpm

F 100,100,1000
C 50,50,0

11111111111111111111
      11000000111111
11111111111111111111
1001000011
100S0000011
110000011
10000011
1000000111111111
1000000000000000111
111111111111111111111