NO ./Texture/colorstone.xpm
SO ./Texture/greystone.xpm
WE ./Texture/colorstone.xpm
EA ./Texture/redbrick.xpm

F 60,40,20
C 128,0,0

11111111111111111111
      11000000111111
11111111111111111111
1011110011
101S0100011
111001011
10111111
1000010111111111
1000000000000000111
111111111111111111111