NO ./Texture/colorstone.xpm
SO ./Texture/greystone.xpm
WE ./Texture/colorstone.xpm
EA ./Texture/redbrick.xpm

F 100,100,123
C 123,234,1111

         11111111111111111111111
        1000000000110000000000001
        1011000001110000000000001
        1001000000000000000000001
 11111111011000001110000000000001
10000000001100000111011111111111
1111011111  11011100000010001
  110111  1 1101  11010010001
1100000011010101 100000010001
10000000000000001100000010001
10000000000000001101010010001
1100000111010101  11011110N0111
11110111 1110101 101111010001
 1111111 1111111 11111111111